airplane mode = Mós Volantis
Bluetooth = Bluetooth
keyboard = cláviátúra
mouse = mús
app = programma
data = data
mail = épistolæ
file = plica
folder = théca
network = réte
CD = discus compactus/CD
DVD = DVD
audio = audítórius,a,um
video = spectátórius,a,um
camera = camera
mobile network = télephónicum réte
access = accessus
input = ingressus
output égressus
web = téla
software = programmata .. (adj)programmaticus,a,um
Music Player = Repróductórium Músicum
user = úsuárius
profile/account = persóna
date = diés
time = tempus
button = clávis
password = tessera
picture = pictúra
printer = pressórium
Backspace = Clávis [déléns] Retró
Space[bar] = Spatium/Clávis Spatií
Enter = Clávis Intró
Shift = Clávis "Shift"
Ctrl/Control = Clávis "Ctrl"
Alt = Clávis "Alt"
Escape key = Clávis „Esc“; interpret. clávis effugiendí.
system = systéma
shortcut = compendium
installation = ínstallátió
to install = ínstalláre
device = ínstrúmentum
plug in = ínserere
run (app) = agere/operáre
Dongle = Ínstrúmentum Bluetooth
Removable Media = Ferculum | Fercula
panel = tabula
Broadband = cónexió láta
default = præoptátus,a,um | præoptandus,a,um
mode/regime = mós + (gen.) act. part.
modes/regimes => ON/OFF = [as]súmere/dépónere
